R 1920 1080
S ./text/walls/greyowl.xpm
NO ./text/walls/greywall.xpm
WE ./text/walls/whitewall.xpm
EA ./text/walls/cement.xpm
SO ./text/walls/whitestone.xpm

C 137, 151, 156
F 46,12,97

111111111111111          11111111
100000000000001          10000001
100000000000001111111111110000001
10201111111020000000000000000N001
100000000000001111111111110000001
111110000000001          10000001
    101002000011111      11111111
    101011100000001
    101000200000001
    101000111110001
    121000000000021
    100000000111111
111110011111111
100000011111111
100000001111111
100020000111111
100000000011111
100000000001111
102000002000111
110000000000011
111000020000001
111100000000001
111110200020001
111111000000001
111111111111111