R 800 600
S ./text/walls/coca.xpm
NO ./text/walls/dani.xpm
WE ./text/walls/tucos.xpm
EA ./text/walls/clari.xpm
SO ./text/walls/nat.xpm
C 86,83,121
F 83,121,121

1111111111111111111111111111
1000000020001000000000000001
1020000000001000001000000001
100000S000000000001000000001
1020000000002000000000000001
1000000000000000002000002001
1020000200002000000002000001
1000000000000000002000000001
1020000200002000000000000001
1111111111111111111111111111