R 1920 1080
S ./text/wolf_tex/barrel.xpm
NO ./text/wolf_tex/mossy.xpm
WE ./text/wolf_tex/redbrick.xpm
EA ./text/wolf_tex/wood.xpm
SO ./text/wolf_tex/stone.xpm

F 50, 50, 50
C 35, 140, 63

        1111111111111111111111111
        1000000000110000000000001
        1001000001110000002000001
        100100000000000N000000001
111111111001000001110000000000001
100000000001000001110111111111111
11110000000000011100000010001
11100111111111011101010010001
11000000110101000000000000201
10002000000000001100000010001
10000000000000001101010010201
110000011101010111110100100111
11110111111101011101111000001
11111111 1111111 111111111111