R 800 600

NO ./text/walls/wall.xpm
WE ./text/walls/wall.xpm
EA ./text/walls/wall.xpm
SO ./text/walls/wall.xpm
D ./text/walls/door.xpm

F ./text/walls/grass.xpm
C 134, 172, 235

        1111111111111111111111111
        1000000000110000000000001
        1001004001110000003000001
        100100000008000N000000001
111111111001000001110000000000001
100000003001000001119111111111111
11100000000100011100000010001
11100111111111011101010310001
11000000110101000000000000001
10000000900000001100000010001
10005000100000001101010010401
11000001110131011111010010011
11110111111101011101111000001
11111111111111111111111111111